14 33
XXXXXXXXXXXXXXXXXXXXXXXXXXXXXXXX
XX           XXX  XXXXXXXXXXXXXX
XX XXXXXXXXX XXXX XXX           
XX XXXXXXXXX XXXX XXX XXXXXXXXXX
XX XXX                XXXXXXXXXX
XX XXX XXXXXXXXXXXXXX      XXXXX
XX XXX           XXXX XXXXXXXXXX
XX XXXXXXXXXXXXX XXXX        XXX
XXXXXXXXXXXXXXXX   XX XXXXXX XXX
XXX         XXXXXX XX XXXXXX   X
XXX XXXXXXX XXXXXXXXX XXXXXXXXXX
XXX XXX XXX                  XXX
XXX     XXXXXXXXXXXXXXXXXXXX XXX
XXXXXXXXXXXXXXXXXXXXXXXXXXXXAXXX